000000000000000000000000000000
000000000000000000000000000000
000000000000000000000000000000
000000000000000000000000000000
000000000000000000000000000000
000000000000000000000000000000
000000000000000000000000002220
000003000000000000022222200000
222222222220022222000111000000
111111111110001110000000000002
111111111100000000000000000000
111111111100000000000000000000
001111111000000000000000000000