40000000000000000000000000000000000000000000000000000000000000
40000000005000000000000000000000000000000000000000000000000000
40000001110000000000000000000000000000000000000000000000000000
40000000000000000000000000000000000000000000000000000000000000
40000000000011111110000000000000000000000000000000000000000000
40003000000000003000000000000000000000000000000000000000000000
40000000000000000000000000022200000000000000000000000000000000
40000000000000000000222222000000000000000000000000000000000000
02222222222200222220001110000000000000000000000000000000000000
01111111111100011100000000000022000000022000100220000000000000
01111111111000000000000000000000000000000000000000000000000000
01111111111000000000000000000000000000000000000000000000000000
00011111110000000000000000000000000000000000000000000000000000
40000000000000000000000000000000000000000000000000000000000000
40000000000000000000000000000000000000000000000000000000000000
40000000000000000000000000000000000000000000000000000000000000
40000000000000000000000000000000000000000000000000000000000000
40000000000000000000000000000000000000000000000000000000000000
40000000000000000000000000000000000000000000000000000000000000
40000000000000000000000000000000000000000000000000000000000000
40000000000000000000000000000000000000000000000000000000000000
40000000000000000000000000000000000000000000000000000000000000
44444444444444444444444444444444444444444444444444444444444444